# data/map.csv (엔진과 호환되는 최종 구조)
width,height,tile
10,8,##########
10,8,#........#
10,8,#.@......#
10,8,#.###..#.#
10,8,#...g..#.#
10,8,#......#.#
10,8,#........#
10,8,##########
